C 0,0,200
F 0,80,0
1111111111111111111111111111111111
1000000000000000000000000000000001
1011111111111111111111111111111101
101                            101
101                            101
101                            101
101         111111111          101
101        1000000001          101
101         111111111          101
101                            101
101                            101
101                            101
101                            101
1011111111111111111111111111111101
1N00000000000000000000000000000001
1111111111111111111111111111111111
