
C 0,0,200
F 0,90,0

NO ./images/BRICK_1A.xpm
SO ./images/BRICK_1A.xpm
WE ./images/BRICK_1A.xpm
EA ./images/BRICK_1A.xpm
      
1111111111111111111111111111111111
1000000000000000000000000000000001
1011111111111111111111111111111101
101                            101
101                            101
101                            101
101         111111111          101
101        1000000001          101
101         111111111          101
101                            101
101                            101
101                            101
101                            101
1011111111111111111111111111111101
100W000000000000000000000000000001
11111111111111111111111111111111111