C 0,0,200
F 0,90,0
11111
100011111111
1S0000000001
1011111111
101
101
101
101
101
111